#########################################################
........#...............................................#
.....1..#...............................................#
#.......#...............................................#
#.......#...............................................#
###...###...............................................#
#.......................................................#
#.......................................................#
#.......................................................#
#.......................................................#
#....M..................................................#
#.......................................................#
#.......................................................#
#.......................................................#
#.......................................................#
#.......................................................#
#.......................................................#
#.......................................................#
#########################################################