#########################################################
........#...............................................#
.....1..#...............................................#
#.......#...............................................#
#.......#...............................................#
###...###...............................................#
#.......................................................#
#.......................................................#
#.......................................................#
#.......................................................#
#....M..................................................#
#.......................................................#
#.......................................................#
#.......................................................#
#.......................................................#
#.......................................................#
#.......................................................#
#.......................................................#
#########################################################
~
.........................................................
........#...............................................#
........#...............................................#
#.......#...............................................#
#.......#...............................................#
###...###...............................................#
#.......................................................#
#.......................................................#
#.......................................................#
#.......................................................#
#.......................................................#
#..........#.....###..#...#.#####.####..................#
#..........#....#...#..#.#..#.....#...#.................#
#..........#....#####...#...####..####..................#
#..........#....#...#...#...#.....#...#.................#
#..........####.#...#...#...#####.#....#................#
#.......................................................#
#.......................................................#
#########################################################